R 800 600

NO	./textures/grass.xpm

SO	./textures/stone.xpm

WE	./textures/metal.xpm

EA	./textures/wood.xpm

C 225,30,0

F 63,225,29

S	./textures/brick.xpm

111111111111111111
111111110001111111
100000000000000111
11111111111100000101
   11100000201111111
  111111110020011111
11100111110000011111
  1110000000000011111
    1100000000011111
    1110N00000011111
    1100000000011111
    1111101111111111
    11111111111
